40 22
****************************************
*###### ##d#r ######r#r######### ##r###*
*#rpr###### ##########rd##r###### ### #*
*########## ##r######r#r##r########r###*
*r#rr#########r#######r#######r###r####*
*r# r######### r##r#########r######r#rr*
*### ##r########r######r# r########r#rr*
*******************************####r##r*
*# ###r##d# ##r#r##########d#rd####### *
*##d#####r#####b########rr r##r#####r##*
*###r##r#r##############r #r##r########*
*#r#####r########rrr#######r## #d####r#*
*#d## ##r#  #####r#rd##d####r###r##d# #*
*# r##############r r##r########d#####r*
*########*******************************
* r#########r###d####r#####r###r#######*
* r######### r##r########r######r#rr##**
*# ##r########r#####r#  ####d###r#rr###*
*####rd##r########r######r#rd######r###*
*### ##r# ##r#rr#########r#rd###### ##r*
*#d#### ##### ######### #r##r####r###r#*
****************************************
